23 30
128 128
2 2 2 2 2 2 2 2 2 2 2 2 2 2 2 2 2 2 2 2 2 2 2
2 0 0 0 0 2 0 1 0 0 0 0 0 0 3 3 3 3 3 3 0 0 2
2 0 1 1 0 2 1 0 0 0 2 0 1 0 3 3 3 3 3 3 0 0 2
2 0 1 1 1 2 1 0 0 2 0 0 1 0 3 3 3 3 3 3 0 0 2
2 0 0 0 0 0 0 0 2 0 0 0 2 2 2 2 2 2 2 2 2 2 2
2 2 0 0 1 0 0 0 0 3 3 3 3 3 3 0 0 2 0 0 0 0 2
2 0 2 0 0 1 1 0 0 3 3 3 3 3 3 0 0 2 0 0 0 4 2
2 0 0 2 0 0 0 0 0 3 3 3 3 3 3 0 1 1 1 1 1 0 2
2 4 5 0 2 0 1 0 0 3 3 3 3 3 3 0 1 1 1 1 1 0 2
2 0 5 0 5 5 0 0 0 3 3 3 3 3 3 0 1 1 1 1 1 4 2
2 2 2 2 2 0 1 0 0 3 3 3 3 3 3 0 1 1 1 1 1 0 2
2 0 0 0 0 1 0 0 0 0 0 5 0 0 0 0 1 1 1 1 1 4 2
2 0 0 0 1 0 0 0 0 2 2 2 2 2 2 0 0 0 0 0 0 0 2
2 0 0 1 0 0 1 0 5 0 0 0 0 5 0 2 0 0 5 0 0 4 2
2 0 1 0 1 0 0 0 0 0 5 5 5 3 3 0 2 0 0 4 4 5 2
2 0 0 0 0 0 1 0 2 2 2 0 0 3 3 0 0 2 2 2 2 2 2
2 0 1 0 0 0 1 1 0 0 0 2 0 0 0 0 2 0 0 5 0 0 2
2 2 2 2 2 2 0 0 0 0 0 0 2 2 2 2 0 5 0 5 5 0 2
2 0 0 0 0 0 0 0 1 0 1 0 0 0 0 0 0 0 0 2 2 2 2
2 0 0 0 0 0 0 0 0 0 0 1 0 0 0 0 0 1 0 2 4 4 2
2 0 0 0 0 1 0 0 2 0 0 0 0 1 0 0 1 0 0 0 4 4 2
2 0 0 0 5 0 0 0 2 0 0 3 0 0 0 1 0 0 1 0 2 2 2
2 0 0 1 0 0 0 0 0 2 2 0 3 0 0 0 2 0 1 0 0 0 2
2 0 0 0 0 0 0 0 2 0 0 2 0 0 0 2 0 0 1 0 1 0 2
2 0 0 0 0 0 0 2 0 4 4 0 2 2 2 0 1 1 2 2 2 2 2
2 0 0 0 0 0 0 2 3 3 3 3 3 3 0 0 0 0 0 0 0 0 2
2 0 0 0 2 2 2 0 3 3 3 3 3 3 0 1 3 3 3 3 3 0 2
2 0 0 2 0 0 1 0 3 3 3 3 3 3 0 0 3 3 3 3 3 0 2
2 0 0 2 0 0 5 0 3 3 3 3 3 3 0 0 3 3 3 3 3 0 2
2 2 2 2 2 2 2 2 2 2 2 2 2 2 2 2 2 2 2 2 2 2 2